13 9
0
3
14	14	14	14	14	14	14	14	14	14	14	14	14
14	9	5	8	12	3	4	3	12	8	5	9	14
14	5	8	12	3	4	6	4	3	12	8	5	14
14	8	12	3	4	6	11	6	4	3	12	8	14
14	12	3	4	6	11	7	11	6	4	3	12	14
14	3	4	6	11	7	2	7	11	6	4	3	14
14	4	6	11	7	2	10	2	7	11	6	4	14
14	6	11	7	2	10	1	10	2	7	11	6	14
14	11	7	2	10	1	13	1	10	2	7	11	14
14	14	14	14	14	14	13	14	14	14	14	14	14




