11 17
1
1
0	0	0	0	0	0	0	0	0	0	0
0	0	0	0	0	0	0	0	0	0	0
0	0	5	0	0	0	0	0	5	0	0
0	0	5	0	0	0	0	0	5	0	0
0	0	0	5	0	0	0	5	0	0	0
0	0	0	5	0	0	0	5	0	0	0
0	0	5	5	5	5   5	5	5	0	0
0	0	5	5	5	5   5	5	5	0	0
0	5	5	7	5	5   5	7	5	5	0
0	5	5	7	5	5   5	7	5	5	0
5	5	5	5	5	5   5	5	5	5	5
5	5	5	5	5	5   5	5	5	5	5
5	5	5	5	5	5   5	5	5	5	5
5	0	5	5	5	5   5	5	5	0	5
5	0	5	0	0	0	0	0	5	0	5
5	0	5	0	0	0	0	0	5	0	5
0	0	0	5	5	0	5	5	0	0	0
0	0	0	5	5	0	5	5	0	0	0




