13 25
0
4
0	0	0	7	2	2	2	2	2	7	0	0	0
0	0	0	0	7	11	2	11	7	0	0	0	0
0	0	0	0	0	7	2	7	0	0	0	0	0
0	0	0	0	0	0	7	0	0	0	0	0	0
0	0	0	0	0	0	0	0	0	0	0	0	0
0	0	0	0	0	0	0	0	0	0	0	0	0
0	0	0	0	0	0	0	0	0	0	0	0	0
0	0	0	0	0	0	0	0	0	0	0	0	0
0	0	0	0	0	0	0	0	0	0	0	0	0
0	0	0	0	0	0	0	0	0	0	0	0	0
3	3	3	3	3	3	13	3	3	3	3	3	3
3	3	10	10	10	13	0	13	10	10	10	3	3
3	1	3	10	13	0	0	0	13	10	3	1	3
3	1	1	14	0	0	0	0	0	14	1	1	3
3	1	14	0	0	0	0	0	0	0	14	1	3
3	14	0	0	0	0	0	0	0	0	0	14	3
14	0	0	0	0	0	0	0	0	0	0	0	14
