9 12
0
0
0	0	0	0	0	0	0	0	0
0	0	0	0	0	0	0	0	0
0	0	0	0	0	0	0	0	0
0	0	0	0	0	0	0	0	0
0	0	0	0	0	0	0	0	0
1	2	3	4	5	4	3	2	1
0	0	0	0	6   0	0	0	0
0	0	0	0	7	0	0	0	0
0	0	0	0	8	0	0	0	0
0	13	0	0	9	0	0	14	0
0	0	0	0	10	0	0	0	0
0	0	0	0	11	0	0	0	0
0	0	0	0	12	0	0	0	0





