13 12
0
2
0	0	0	0	0	0	0	0	0	0	0	0	0
1	0	0	0	0	0	0	0	0	0	0	0	1
0	1	0	0	0	0	0	0	0	0	0	1	0
0	0	1	0	0	0	0	0	0	0	1	0	0
0	0	0	1	1	1	1	1	1	1	0	0	0
0	0	0	1	2	2	11	2	2	1	0	0	0
0	0	0	1	2	8	11	8	2	1	0	0	0
0	0	0	1	11	11	14	11	11	1	0	0	0
0	0	0	1	2	8	11	8	2	1	0	0	0
0	0	0	1	2	2	11	2	2	1	0	0	0
0	0	0	1	1	1	1	1	1	1	0	0	0
0	0	0	0	0	0	0	0	0	0	0	0	0
0	0	0	0	0	0	0	0	0	0	0	0	0
0	0	0	0	0	0	13	0	0	0	0	0	0




